1111111111111
10010000100C1
1000011111001
1P0011E000011
1111111111111
